NO ./files/textures/North_wall.xpm
SO ./files/textures/South_wall.xpm
WE ./files/textures/West_wall.xpm
EA ./files/textures/East_wall.xpm
F 46,31,2
C 0,0,0

        1111111111111111111111111
        1000000000110000000000001
        101100000111000000000W001
        1001000000000000000000001
111111111011000001110000000000001
100000000011000001110111111111111
11110111111111011100000010001
11110111111111011101010010001
11000000110101011100000010001
10001000000000001100000010001
10010000000000001101010010001
1100000111010101111101111000111
11110111 1110101 101111010001
11111111 1111111 111111111111