		1111111111111111111111111		
		10000000001101111000000011111		
		10110000011101  1000000000001		
		10010000000001111000000011111	1111
111111111011000001110000000000001		1001
100000000011000001110111111111111		1001
11110111111111011100000010001111111111111001
11110111111111011101010010001000000000000001
11000000110101011100000010001111111111111111
10000000000000001100000010001
10000000000000001101010010001
11000001110101011111011110N01
11110111 1110101 101111010001
11111111 1111111 111111111111